{
  "tileSize": 50,
  "map": [
    "11111111111111111111",
    "1S000000100000000001",
    "10111110101111101101",
    "10000000100000100001",
    "10111111111110111101",
    "10000000000000100001",
    "11110111111111101111",
    "10000100000000100001",
    "10111101111110111001",
    "10000001000000100001",
    "101111110111111011G1",
    "11111111111111111111"
  ]
}
